border_size=1
usage=map

Qlf, Qlf, Qlf, Qlf, Xu, Xu, Uu^Ii, Uu^Ii, Uu^Ii, Xu, Xu, Qlf, Qlf, Qlf, Qlf
Qlf, Qlf, Xu, Xu, Uu^Ii, Uu^Ii, Cud, Cud, Cud, Uu^Ii, Uu^Ii, Xu, Xu, Qlf, Qlf
Xu, Xu, Uu^Ii, Uu^Ii, Cud, Cud, Ql^Bs\, Ql^Bs|, Ql^Bs/, Cud, Cud, Uu^Ii, Uu^Ii, Xu, Xu
Cud, Uu^Ii, Uu^Ii, Uu^Ii, Cud, Cud, Ql^Bs/, Kud, Ql^Bs\, Cud, Cud, Uu^Ii, Uu^Ii, Uu^Ii, Cud
Cud, Cud, Cud, Cud, Cud, Cud, Cud, Ql^Bs|, Cud, Cud, Cud, Cud, Cud, Cud, Cud
Cud, Cud, Qxu^Bs|, Cud, Cud, Uu^Uf, Uu^Uf, Cud, Uu^Uf, Uu^Uf, Cud, Cud, Qxu^Bs|, Cud, Cud
Cud, Qxu^Bs\, Uu^Ii, Qxu^Bs/, Cud, Uu^Uf, Cud, Cud, Cud, Uu^Uf, Cud, Qxu^Bs\, Uu^Ii, Qxu^Bs/, Cud
Cud, Qxu^Bs/, Qxu^Bs|, Qxu^Bs\, Cud, Cud, Cud, Cud, Cud, Cud, Cud, Qxu^Bs/, Qxu^Bs|, Qxu^Bs\, Cud
Cud, Uh, Qxu^Bs|, Uh, Cud, Cud, Cud, Cud, Cud, Cud, Cud, Uh, Qxu^Bs|, Uh, Cud
Cud, Qxu^Bs\, Uu^Ii, Qxu^Bs/, Cud, Cud, Cud, Cud, Cud, Cud, Cud, Qxu^Bs\, Uu^Ii, Qxu^Bs/, Cud
Cud, Qxu^Bs/, Qxu^Bs|, Qxu^Bs\, 1 Cud, Uu^Uf, Cud, Cud, Cud, Uu^Uf, Cud, Qxu^Bs/, Qxu^Bs|, Qxu^Bs\, Cud
Cud, Cud, Cud, Cud, Cud, Uu^Uf, Cud, Cud, Cud, Uu^Uf, Cud, Cud, Cud, Cud, Cud
