border_size=1
usage=map

Hh, Hh, Mm^Xm, Hh, Hh, Gg, Gg, Gg, Gg, Gg, Gg, Gg, Gg, Gg, Gg, Gg, Gg, Gg, Gg, Gg, Gg, Gg
Mm^Xm, Mm^Xm, Mm^Xm, Mm^Xm, Gg, Gs^Fp, Gg, Gg, Gg, Gg, Hh, Gg, Hh, Gg, Hh, Gg, Gg, Gg, Gg, Gs^Fp, Gg, Gg
Hh, Mm^Xm, Hh, Gg, Gg, Gs^Fp, Gg, Gs^Fp, Gg, Hh, Rb, Hhd, Hhd, Hh, Gg, Gg, Gg, Gg, Gg, Gg, Gg, Gg
Gg, Gg, Hh, Gg, Gg, Gg, Gg, Gg, Gg, Rb, Rb^Xo, Rb^Xo, Rb^Xo, Rb, Gg, Gg, Gs^Fp, Gg, Hh, Gg, Gg, Gg
Gg, Hh, Hh, Gg, Gs^Fp, Gg, Gg, Gg, Gg, Rb, Rb^Xo, Rb^Vh, Rb^Xo, Rb, Gg, Gg, Gg, Gg, Gg, Hh, Gg, Gg
Gg, Gg, Gg, Gg, Gs^Fp, Gg, Gg, Gg, Gg, Rb, Rb, Rb^Xo, Rb, Rb, Gg, Gg, Gg, Gs^Fp, Gg, Hh, Gg, Gg
Gg, Gg, Gg, Gg, Gg, Gs^Fp, Gg^Vh, Gg, Gs^Fp, Gg, Hh, Rd, Hh, Hh, Gg, Gg, Gs^Fp, Gs^Fp, Gg, Gg, Gg, Gg
Gg, Gg, Gg, Gg, Gg, Gs^Fp, Gg, Rd, Gs^Fp, Gg, Rd, Rd, Gs^Fp, Gg, Gg, Gg, Gg, Gg, Gg, Gg, Gg, Gg
Gg, Gg, Gg, Gg, Gg, Gg, Gg, Rd, Rd, Gg, Rd, Gs^Fp, Rd, Gg, Rd, Gg, Hh, Gg, Gg, Gg, Gg, Gg
Gg, Gg, Gg, Gs^Fp, Hh, Hh, Hh, Gg, Gg, Rd, Rd, Rd, Gg, Rd, Gg, Gg^Vh, Hh, Hh, Hh, Gg, Gg, Gg
Gg, Gg, Gg, Gs^Fp, Hh, Hh, Gg, Gg, Gg, Rd, Gg, Gg, Gs^Fp, Gg, Gg, Hh, Hh, Gg, Gg, Gg, Gg, Gg
Gg, Gg, Gg, Gs^Fp, Gs^Fp, Gs^Fp, Gs^Fp, Gg, Gg, Rd, Hh, Hh, Gs^Fp, Gg, Gg, Gg, Gg, Gg, Gg, Gg, Gg, Gg
Gg, Gg, Gg, Gg, Gg^Vh, Gg, Gg, Gg, Gg, Rd, Hh, Hh, Hh, Gs^Fp, Gg, Gg, Gg, Gs^Fp, Gs^Fp, Gg, Gg, Gg
Gg, Gg, Gg, Gg, Gg, Rd, Rd, Rd, Rd, Rd, Rd, Hh, Gs^Fp, Gs^Fp, Gg^Vh, Gg, Gg, Gs^Fp, Gg, Gs^Fp, Gg, Gg
Gg, Gg, Gg, Gg, Gg, Hh, Hh, Gg, Gg, Gg, Rd, Gs^Fp, Gg, Gg, Rd, Gg^Vh, Gg, Gs^Fp, Gg, Gg, Gg, Gg
Gg, Gg, Hh, Gg, Gg, Gg, Gg, Hh, Hh, Gg, Rd, Gg, Rd, Rd, Gg, Gg, Hh, Gg, Hh, Gg, Gg, Gg
Gg, Gg, Hh, Gg, Gs^Fp, Gg, Gg, Hh, Gg, Gg, Gg, Rd, Gg, Gg, Gg, Hh, Gg, Hh, Gg, Hh, Gg, Gg
Gg, Hh, Hh, Gg, Gg, Gs^Fp, Gs^Fp, Gg, Gg, Gg, Gg, Rd, Gg, Gg, Gs^Fp, Gg, Gs^Fp, Gg, Gg, Gg, Gg, Gg
Gg, Hh, Hh, Gg, Gg, Gg, Gs^Fp, Gs^Fp, Gg, Gg, Gg, 1 Rd, Gg, Gg, Gg, Gs^Fp, Gs^Fp, Gs^Fp, Gg, Gg, Gg, Gg
Gg, Gg, Gg, Gg, Gg, Gg, Gg, Gg, Gg, Gg, Gg, Rd, Gg, Gg, Gg, Gg, Gg, Gg, Gg, Gg, Gg, Gg
Gg, Gg, Gg, Gg, Gg, Gg, Gg, Gg, Gg, Gg, Gg, Rd, Rd, Gg, Gg, Gg, Gg, Gg, Gg, Gg, Gg, Gg
Gg, Gg, Gg, Gg, Gg, Gg, Gg, Gg, Gg, Gg, Gg, Gg, Gg, Rd, Gg, Gg, Gg, Gg, Gg, Gg, Gg, Gg
