border_size=1
usage=map

Md^Xm, Md^Xm, Md^Xm, Md^Xm, Md^Xm, Md^Xm, Md^Xm, Md^Xm, Md^Xm, Md^Xm, Md^Xm, Md^Xm, Md^Xm, Md^Xm, Md^Xm, Md^Xm, Md^Xm, Md^Xm, Md^Xm, Md^Xm, Md^Xm, Md^Xm, Md^Xm, Md^Xm, Md^Xm, Md^Xm, Md^Xm, Md^Xm, Md^Xm, Md^Xm, Wo, Md^Xm
Md^Xm, Md^Xm, Wwg, Md^Xm, Wwg, Md^Xm, Md^Xm, Md^Xm, Md^Xm, Md^Xm, Wwg, Md^Xm, Wwg, Wwg, Wwg, Wwg, Wwg, Md^Xm, Wwg, Md^Xm, Wwg, Md^Xm, Wwg, Md^Xm, Wwg, Md^Xm, Wwg, Md^Xm, Wo, Wo, Md^Xm, Md^Xm
Md^Xm, Md^Xm, Wwrg, Wwg, Uh, Wwg, Wwg, Wwg, Wwg, Wwg, Uh, Wwg, Uh, Uh, Uh, Uh, Uh, Wwg, Wwrg, Wwg, Uh, Wwg, Uh, Wwg, Wwg, Wog, Wo, Wo, Wo, Md^Xm, Md^Xm, Md^Xm
Md^Xm, Md^Xm, Wwrg, Wwrg, Uh, Uh, Uh, Uh, Uh, Uh, Uh, Uh, Uh, Uh, Wwg, Uh, Wwg, Uh, Wwg, Uh, Wwg, Wwrg, Wwg, Uh, Uh, Wwg, Wo, Wo, Wo, Md^Xm, Md^Xm, Md^Xm
Md^Xm, Md^Xm, Uh, Uh, Uh, Uh, Wwg, Uh, Wog, Wwg, Wwg, Wwg, Wwg, Wwg, Wog, Wwg, Wwg, Wwg, Wog, Wwg, Wwg, Wwg, Wog, Wwg, Wwg, Uh, Wo, Wo, Wo, Wwg, Md^Xm, Md^Xm
Md^Xm, Md^Xm, Wwg, Wwg, Wwg^Bw|r, Wwg, Wog, Wog, Wog, Wog, Wwg, Wog, Wwg, Wwg, Wwg, Wwg, Wwg, Wog, Wog, Wog, Wwg, Wog, Wog, Wwg, Wwg, Uh, Wo^Bw\r, Wo, Wog, Wwg, Wwg, Md^Xm
Md^Xm, Wwrg, Uh, Wwg, Wwg^Bw|r, Wwg, Wwg, Wwg, Wwg, Wwg, Uh, Wwg, Uh, Uh, Uh, Uh, Uh, Wwg, Wwg, Wwg, Wwg, Wog, Wog, Wog, Wo, Wwg, Wo, Wo^Bw\r, Uh, Uh, Uh, Md^Xm
Md^Xm, Wwrg, Uh, Uh, Uh, Wwg, Wwg, Wwg, Uh, Uh, Uh, Uh, Uh, Uh, Md^Xm, Uh, Uh, Uh, Uh, Uh, Wwrg, Wwg, Wwg, Wog, Wo, Wo, Wo, Wo, Uh, Uh, Md^Xm, Md^Xm
Md^Xm, Wwrg, Uh, Uh, Uh, Wwg, Wwg, Wwg, Uh, Wwrg, Uh, Uh, Md^Xm, Md^Xm, 2 Wog, Md^Xm, Md^Xm, Uh, Uh, Uh, Uh, Uh, Wwg, Wog, Wo, Wo, Wo, Wog, Uh, Uh, Md^Xm, Md^Xm
Md^Xm, Wwrg, Uh, Uh, Uh, Wwg, Wog, Uh, Uu^Dr, Uh, Md^Xm, Md^Xm, Wog, Wog, Wog, Wog, Wog, Md^Xm, Md^Xm, Uh, Uh, Uh, Wwg, Wog, Wo, Wo, Wo, Wog, Uh, Uh, Md^Xm, Md^Xm
Md^Xm, Wwrg, Uh, Uh, Uh, Wwg, Wwg, Wwg^Bw\r, Uh, Md^Xm, Wog, Wog, Wog, Wog, Wog, Wog, Wog, Wog, Wog, Md^Xm, Uh, Uh, Wwg, Wog, Wog, Wo, Wog, Wog, Wwg, Uh, Md^Xm, Md^Xm
Md^Xm, Wwrg, Wwg, Uh, Uu^Dr, Wwg, Wog, Uh, Uh, Md^Xm, Wog, Wog, Wog, Wog, Wog, Wog, Wog, Wog, Wog, Md^Xm, Uh, Uh, Wwg, Wog, Wog, Wog, Wog, Uh, Uh, Uh, Md^Xm, Md^Xm
Md^Xm, Md^Xm, Wwg, Uh, Wwg, Wwg, Wwg, Wwg^Bw/r, Uh, Md^Xm, Wog, Wog, Wog, Wog, Wog, Wog, Wog, Wog, Wog, Md^Xm, Uh, Uh, Wwg, Wog, Wog, Wog, Wog, Uh, Uh, Md, Md, Md^Xm
Md^Xm, Md^Xm, Wwg, Uh, Uh, Wwg^Bw/r, Wog, Uh, Uh, Md^Xm, Wog, Wog, Wog, Wog, Wog, Wog, Wog, Wog, Wog, Md^Xm, Uh, Uh, Wwg, Wog, Wog, Wog, Wog, Wwg, Uh, Uh, Md^Xm, Md^Xm
Md^Xm, Wwg, Wwg, Uh, Wwg, Wwg, Wog, Uh, Uh, Md^Xm, Md^Xm, Wog, Wog, Wog, Wog, Wog, Wog, Wog, Wog, Md^Xm, Uu^Dr, Uh, Wwg, Wog, Wog, Wog, Wog, Wog^Bw/r, Wog, Uh, Md^Xm, Md^Xm
Md^Xm, Wwg, Wwg, Uh, Wwg, Wog, Wog, Wog, Uh, Uh, Uh, Md^Xm, Md^Xm, Wog, Wog, Wog, Wog, Wwg, Wwg, Md^Xm, Md^Xm, Uh, Wog, Wog, Wog, Wog, Wog, Wog, Wog, Wog, Wog, Md^Xm
Md^Xm, Wwg, Wog, Wwg^Bw|r, Wog, Wog, Wog, Wog, Uh, Uh, Uh, Uh, Uh, Md^Xm, Md^Xm, Wog, Md^Xm, Wwg, Wwg, Wwg, Wwg, Wwg, Uh, Wog^Bw/r, Wog, Wog, Wog, Wog, Wog, Wog, Wog, Md^Xm
Md^Xm, Wwg, Wog, Wog, Wog, Wog, Wog, Wog, Wwg, Uh, Uh, Uh, Uh, Uh, Uh, Md^Xm, Uh, Md^Xm, Wwg, Wwg, Wwg, Wwg, Wwg, Wwg, Wog, Wog, Wog, Wog, Wog, Wog, Wog, Md^Xm
Md^Xm, Wwg, Wwg, Wwg^Bw|r, Wwg, Wog, Wog, Wog, Wog, Wwg, Wwg, Uh, Wwg, Uh, Wwg, Uh, Wwg, Uh, Wwg, Wwg, Wwg, Wwg, Wwg, Wog, Wog, Wo, Wo, Wo, Wog, Wog, Wog, Md^Xm
Md^Xm, Wwg, Uh, Uh, Uh, Wwg, Wog, Wog, Wog, Wog, Wog, Wwg, Wwg, Wwg, Wwg, Wwg, Wwg, Wwg, Wwg, Wwg, Wwg, Wwg, Wwg, Wog, Wog, Wo, Wo, Wo, Wog, Wog, Wog, Md^Xm
Md^Xm, Wwg, Wwg, Uh, Wwg, Wwg, Wog, Wog, Wog, Wog, Wog, Wwg, Wwg, Wwg, Wwg, Wwg, Wwg, Wwg, Wwg, Wwg, Wwg, Wwg, Wwg, Wwg, Wo, Wo, Wo, Wo, Wog, Wog, Wog, Md^Xm
Md^Xm, Wwg, Wog, Wwg^Bw|r, Wog, Wog, Wog, Wog, Wog, Wog, Wog, Wog, Wog, Wog, Wog, Wog, Wwg, Wwg, Uh, Wwg, Wwg, Wwg, Wog, Wog, Wo, Wo, Wo, Wo, Wog, Wog, Md^Xm, Md^Xm
Md^Xm, Wwg, Wog, Wog, Wog, Wog, Wo, Wog, Wog, Wog, Wog, Wog, Wog, Wo, Wog, Wog, Wog, Wwg, Wwg, Wwg, Wwg, Wog, Wog, Wo, Wo, Wo, Wo, Wog, Wog, Wog, Md^Xm, Md^Xm
Md^Xm, Md^Xm, Wog, Wog, Wog, Wog, Wo, Wo, Wo, Wog, Wog, Wog, Wo, Wo, Wog, Wog, Wog, Wog, Wog, Wog, Wog, Wog, Wog, Wo, Wo, Wo, Wo, Wog, Wog, Wog, Md^Xm, Md^Xm
Md^Xm, Md, Md, Wog, Wog, Wog, Wog, Wo, Wo, Wo, Wo, Wo, Wo, Wo, Wog, Wog, Wog, Wog, Wog, Wog, Wog, Wog, Wo, Wo, Wo, Wo, Wo, Wog, Wog, Wog, Md^Xm, Md^Xm
Md^Xm, Md, Md, Md, Md, Wog, Wog, Wo, Wo, Wo, Wo, Wo, Wo, Wo, Wo, Wog, Wog, Wog, Wog, Wog, Wog, Wog, Wo, Wo, Wo, Wo, Wog, Wog, Wog, Wog, Md^Xm, Md^Xm
Md^Xm, Md, Md, Md, Co, Md, Md, Wog, Wog, Wo, Wo, Wo, Wo, Wo, Wo, Wo, Wo, Wog, Wo, Wog, Wog, Wo, Wo, Wo, Wo, Wo, Wog, Wog, Wog, Wog, Wog, Md^Xm
Md^Xm, Md, Md, Co, 3 Ko, Co, Md, Md, Md, Wog, Wog, Wo, Wo, Wo, Wo, Wo, Wo, Wo, Wo, Wog, Wog, Wo, Wo, Wo, Wog, Wog, Wog, Wog, Wog, Wog, Wog, Md^Xm
Md^Xm, Md, Md, Co, Co, Co, Md, Md, Md, Md, Wog, Wog, Wog, Wo, Wo, Wo, Wo, Wo, Wo, Wo, Wo, Wo, Wo, Wog, Wog, Wog, Wog, Wog, Wog, Wog, Xu, Md^Xm
Md^Xm, Md, 1 Md, Md, Md, Md, Md, Md, Md, Md, Wog, Wog, Wog, Wog, Wog, Wog, Ce, Wo, Wo, Wo, Wo, Wo, Wog, Wog, Wog, Wog, Wog, Wog, Xu, Wog, Wog, Xu
Md^Xm, Md, Md, Md, Md^Xm, Md, Md^Xm, Md, Md^Xm, Md^Xm, Md^Xm, Md, Md, Wog, Ce, Ce, Wo, Wo, Ce, Wog, Md, Wog, Md, Wog, Md^Xm, Wog, Md^Xm, Md^Xm, Md^Xm, Xu, Xu, Xu
Md, Md, Md^Xm, Md^Xm, Md^Xm, Md^Xm, Md^Xm, Md^Xm, Md^Xm, Md^Xm, Md^Xm, Md, Md^Xm, Md, Md, Uh, Wwr, Uh, Md, Md, Md^Xm, Md, Md^Xm, Md^Xm, Md^Xm, Md^Xm, Md^Xm, Md^Xm, Md^Xm, Md^Xm, Md^Xm, Md^Xm
