border_size=1
usage=map

Md^Xm, Md^Xm, Md^Xm, Md^Xm, Md^Xm, Md^Xm, Md^Xm, Md^Xm, Md^Xm, Md^Xm, Md^Xm, Md^Xm, Md^Xm, Md^Xm, Md^Xm, Md^Xm, Md^Xm, Md^Xm, Md^Xm, Md^Xm, Md^Xm, Md^Xm, Md^Xm, Md^Xm, Md^Xm, Md^Xm, Md^Xm, Md^Xm, Md^Xm, Md^Xm, Wo, Md^Xm
Md^Xm, Md^Xm, Wog, Md^Xm, Wog, Md^Xm, Md^Xm, Md^Xm, Md^Xm, Md^Xm, Wog, Md^Xm, Wog, Wog, Wog, Wog, Wog, Md^Xm, Wog, Md^Xm, Wog, Md^Xm, Wog, Md^Xm, Wog, Md^Xm, Wog, Md^Xm, Wo, Wo, Md^Xm, Md^Xm
Md^Xm, Md^Xm, Wog, Wog, Wog, Wog, Wog, Wog, Wog, Wog, Wog, Wog, Wog, Wog, Wog, Wog, Wog, Wog, Wog, Wog, Wog, Wog, Wog, Wog, Wog, Wog, Wo, Wo, Wo, Md^Xm, Md^Xm, Md^Xm
Md^Xm, Md^Xm, Wog, Wog, Wog, Wog, Wog, Wog, Wog, Wog, Wog, Wog, Wog, Wog, Wog, Wog, Wog, Wog, Wog, Wog, Wog, Wog, Wog, Wog, Wog, Wog, Wo, Wo, Wo, Md^Xm, Md^Xm, Md^Xm
Md^Xm, Md^Xm, Wog, Wog, Wog, Wog, Wog, Wog, Wog, Wog, Wog, Wog, Wog, Wog, Wog, Wog, Wog, Wog, Wog, Wog, Wog, Wog, Wog, Wog, Wog, Wog, Wo, Wo, Wo, Wo^Ewl, Md^Xm, Md^Xm
Md^Xm, Md^Xm, Wog, Wog, Wog, Wog, Wog, Wog, Wog, Wog, Wog, Wog, Wog, Wog, Wog, Wog, Wog, Wog, Wog, Wog, Wog, Wog, Wog, Wog, Wog, Wog, Wo, Wo, Wog, Wog, Wog, Md^Xm
Md^Xm, Wog, Wog, Wog, Wog, Wog, Wog, Wog, Wog, Wog, Wog, Wog, Wog, Wog, Wog, Wog, Wog, Wog, Wog, Wog, Wog, Wog, Wog, Wog, Wo, Wo, Wo, Wo, Wog, Wog, Wog, Md^Xm
Md^Xm, Wog, Wog, Wog, Wog, Wog, Wog, Wog, Wog, Wog, Wog, Wog, Wog, Wog, Md^Xm, Wog, Wog, Wog, Wog, Wog, Wog, Wog, Wog, Wog, Wo, Wo, Wo, Wo, Wog, Wog, Md^Xm, Md^Xm
Md^Xm, Wog, Wog, Wog, Wog, Wog, Wog, Wog, Wog, Wog, Wog, Wog, Md^Xm, Md^Xm, 2 Khr, Md^Xm, Md^Xm, Wog, Wog, Wog, Wog, Wog, Wog, Wog, Wo, Wo, Wo, Wog, Wog, Wog, Md^Xm, Md^Xm
Md^Xm, Wog, Wog, Wog, Wog, Wog, Wog, Wog, Wog, Wog, Md^Xm, Md^Xm, Chr, Chr, Chr, Chr, Chr, Md^Xm, Md^Xm, Wog, Wog, Wog, Wog, Wog, Wo, Wo, Wo, Wog, Wog, Wog, Md^Xm, Md^Xm
Md^Xm, Wog, Wog, Wog, Wog, Wog, Wog, Wog, Wog, Md^Xm, Wwg, Chr, Wog, Chr, Chr, Chr, Wwg, Chr, Wog, Md^Xm, Wog, Wog, Wog, Wo, Wo, Wo, Wog, Wog, Wog, Wog, Md^Xm, Md^Xm
Md^Xm, Wog, Wog, Wog, Wog, Wog, Wog, Wog, Wog, Md^Xm, Wwg, Wwg, Wog, Chr, Wog, Chr, Wwg, Wwg, Wog, Md^Xm, Wog, Wog, Wog, Wo, Wo, Wo, Wog, Wog, Wog, Wog, Md^Xm, Md^Xm
Md^Xm, Md^Xm, Wog, Wog, Wog, Wog, Wog, Wog, Wog, Md^Xm, Wwg, Wwg, Wog, Chr, Wog, Chr, Wog, Wwg, Wog, Md^Xm, Wog, Wog, Wog, Wo, Wo, Wo, Wog, Wog, Wog, Md, Md, Md^Xm
Md^Xm, Md^Xm, Wog, Wog, Wog, Wog, Wog, Wog, Wog, Md^Xm, Wwg, Hd, Wog, Wog, Wog, Wog, Wog, Wog, Wog, Md^Xm, Wog, Wog, Wog, Wo, Wo, Wo, Wo, Wog, Wog, Wog, Md^Xm, Md^Xm
Md^Xm, Wog, Wog, Wog, Wog, Wog, Wog, Wog, Wog, Md^Xm, Md^Xm, Wwg, Wwg, Hd, Wog, Wog, Wog, Wog, Chw, Md^Xm, Wog, Wog, Wog, Wo, Wo, Wo, Wo, Wog, Wog, Wog, Md^Xm, Md^Xm
Md^Xm, Wog, Wog, Wog, Wog, Wog, Wog, Wog, Wog, Wog, Wog, Md^Xm, Md^Xm, Wog, Wwg, Wog, Chw, Wog, Wog, Md^Xm, Md^Xm, Wog, Wog, Wo, Wo, Wo, Wo, Wog, Wog, Wog, Wog, Md^Xm
Md^Xm, Wog, Wog, Wog, Wog, Wog, Wog, Wog, Wog, Wog, Wog, Wog, Wog, Md^Xm, Md^Xm, Wog, Md^Xm, Wog, Wog, Wog, Wog, Wog, Wog, Wog, Wog, Wo, Wo, Wo, Wo, Wog, Wog, Md^Xm
Md^Xm, Wog, Wog, Wog, Wog, Wog, Wog, Wog, Wog, Wog, Wog, Wog, Wog, Wog, Wog, Md^Xm, Wog, Md^Xm, Wog, Wog, Wog, Wog, Wog, Wog, Wog, Wo, Wo, Wo, Wo, Wog, Wog, Md^Xm
Md^Xm, Wog, Wog, Wog, Wog, Wog, Wog, Wog, Wog, Wog, Wog, Wog, Wog, Wog, Wog, Wog, Wog, Wog, Wog, Wog, Wog, Wog, Wog, Wog, Wog, Wo, Wo, Wo, Wo, Wog, Wog, Md^Xm
Md^Xm, Wog, Wog, Wog, Wog, Wog, Wo, Wo, Wo, Wo, Wo, Wog, Wog, Wog, Wog, Wog, Wog, Wog, Wog, Wog, Wog, Wog, Wog, Wog, Wog, Wo, Wo, Wo, Wo, Wog, Wog, Md^Xm
Md^Xm, Wog, Wog, Wog, Wog, Wog, Wo, Wo, Wo, Wo, Wo, Wo, Wo, Wog, Wog, Wog, Wog, Wog, Wog, Wog, Wog, Wog, Wog, Wog, Wo, Wo, Wo, Wo, Wo, Wog, Wog, Md^Xm
Md^Xm, Wog, Wog, Wog, Wog, Wo, Wo, Wo, Wo, Wo, Wo, Wo, Wo, Wo, Wo, Wog, Wog, Wog, Wog, Wog, Wog, Wog, Wo, Wo, Wo, Wo, Wo, Wo, Wo, Wog, Md^Xm, Md^Xm
Md^Xm, Wog, Wog, Wog, Wog, Wo, Wo, Wo, Wo, Wo, Wo, Wo, Wo, Wo, Wo, Wog, Wog, Wog, Wog, Wog, Wog, Wog, Wog, Wo, Wo, Wo, Wo, Wo, Wo, Wog, Md^Xm, Md^Xm
Md^Xm, Md^Xm, Wog, Wog, Wog, Wo, Wo, Wo, Wo, Wo, Wo, Wo, Wo, Wo, Wo, Wog, Wog, Wog, Wog, Wog, Wog, Wog, Wog, Wo, Wo, Wo, Wo, Wo, Wo, Wog, Md^Xm, Md^Xm
Md^Xm, Md, Md, Wog, Wog, Wo, Wo, Wo, Wo, Wo, Wo, Wo, Wo, Wo, Wo, Wo, Wo, Wog, Wo, Wog, Wog, Wog, Wo, Wo, Wo, Wo, Wo, Wo, Wo, Wog, Md^Xm, Md^Xm
Md^Xm, Md, Md, Md, Md, Wog, Wog, Wo, Wo, Wo, Wo, Wo, Wo, Wo, Wo, Wo, Wo, Wo, Wo, Wo, Wo, Wo, Wo, Wo, Wo, Wo, Wog, Wo, Wog, Wog, Md^Xm, Md^Xm
Md^Xm, Md, Md, Md, Co, Md, Md, Wog, Wog, Wo, Wo, Wo, Wo, Wo, Wo, Wo, Wo, Wo, Wo, Wo, Wo, Wo, Wo, Wo, Wo, Wo, Wog, Wog, Wog, Wog, Wog, Md^Xm
Md^Xm, Md, Md, Co, 3 Ko, Co, Md, Md, Md, Wog, Wog, Wo, Wo, Wo, Wo, Wo, Wo, Wo, Wo, Wo, Wo, Wo, Wo, Wo, Wo, Wo, Wog, Wog, Wog, Wog, Wog, Md^Xm
Md^Xm, Md, Md, Co, Co, Co, Md, Md, Md, Md, Wog, Wo, Wo, Wo, Wo, Wo, Wo, Wo, Wo, Wo, Wo, Wo, Wo, Wo, Wo, Wog, Wog, Wog, Wog, Wog, Xu, Md^Xm
Md^Xm, Md, 1 Md, Md, Md, Md, Md, Md, Md, Md, Wog, Wog, Wog, Wo, Wo, Wo, Ce, Wo, Wo, Wo, Wo, Wo, Wog, Wo, Wog, Wog, Wog, Wog, Xu, Wog, Wog, Xu
Md^Xm, Md, Md, Md, Md^Xm, Md, Md^Xm, Md, Md^Xm, Md^Xm, Md^Xm, Md, Md, Wog, Ce, Ce, Wwr, Ce, Ce, Wo, Md, Wog, Md, Wog, Md^Xm, Wog, Md^Xm, Md^Xm, Md^Xm, Xu, Xu, Xu
Md, Md, Md^Xm, Md^Xm, Md^Xm, Md^Xm, Md^Xm, Md^Xm, Md^Xm, Md^Xm, Md^Xm, Md, Md^Xm, Md, Md, Uh, Wwr, Uh, Md, Md, Md^Xm, Md, Md^Xm, Md^Xm, Md^Xm, Md^Xm, Md^Xm, Md^Xm, Md^Xm, Md^Xm, Md^Xm, Md^Xm
